0000000000000000000000000
0000000000000000000000000
0000000000000000000000000
0000000000000000000000000
0000000000000000000000000
0000000000000000000000000
0000000000000000000000000
0000000000000000000000000
0000000000000000000000000
0000000000000000000000000
0000000000000000000000000
000000000000000000000D000
0000000000000000000000000
0000000000000000000000000
0000000000000000000000000
00P0000000000000000000000
0000000000000000000000000
0000000000000000000000000
0000000000000000000000000

1111111111111111111111111
1000000000000000000000001
1000000000000000000000001
1000000000000000000000001
1000000000000000000000001
1000000000000000000000001
1000000000000000000000001
1000000000000000000000001
1000000000000000000000001
1000000000000000000000001
1000000000000000000000001
1000000000000000000000001
1000000000000000000000001
1000000000000000000000001
1000000000001111111111111
1000000001111111111111111
1000000111111111111111111
1000001111111111111111111
1111111111111111111111111